
NO ./a.xpm
SO 25,53,54
WE 10,10,10

C 0,0,  255
F 255,0,0

EA 45,91,51

1111
10001              1
1111111111111111111N1
11111              1
1111111111111111111111
