C 1,1,1
F 1,1,1

NO ./a.xpm
EA ./a.xpm
SO ./a.xpm
WE ./a.xpm

P=0

111111111111111
11100000000N111
111111111111111