1 {
	NO textures/simonkraft/bookshelf_01.xpm
	SO textures/simonkraft/bookshelf_01.xpm
	EA textures/simonkraft/bookshelf_01.xpm
	WE textures/simonkraft/bookshelf_01.xpm
	C 0,0,0
	F 0,0,0
	CH 100
	FH 0
	W 1
}
2 {
	NO 200,200,200 1
	SO 200,200,200 1
	EA 200,200,200 1
	WE 200,200,200 1
	C 0,0,0
	F 0,0,0
	CH 100
	FH 0
	W 1
}
0 {
	NO textures/simonkraft/bookshelf_01.xpm
	SO textures/simonkraft/bookshelf_02.xpm
	WE textures/simonkraft/bookshelf_03.xpm
	EA textures/simonkraft/bookshelf.xpm
	C textures/wolfenstein/wood.xpm
	F textures/wolfenstein/grey_stone.xpm
	CH 100
	FH 0
	W 0
}
P=0

L ((4.1, 4.1), {255, 0, 0}, 1)
L ((2.1, 4.1), {0, 255, 0}, 1)
L ((4.1, 2.1), {0, 0, 255}, 1)


1112222111
1000000001
1000000001
1000000001
1000000001
1000000001
1000000E01
1111111111