1 {
	NO 200,200,200
	SO 200,200,200
	EA 200,200,200
	WE 200,200,200
	C 200,200,200
	F 200,200,200
	W 1
}
2 {
	C 200,200,200
	F 200,200,200
	W 1
	wt 200,200,200
	wa ((1, 0.5), (0.5, 1), (0.5, 0.5))
}
3 {
	C 200,200,200
	F 200,200,200
	W 1
	wt 200,200,200
	wa ((0.5, 1), (0, 0.5), (0.5, 0.5))
}
4 {
	C 200,200,200
	F 200,200,200
	W 1
	wt 200,200,200
	wa ((0, 0.5), (0.5, 0), (0.5, 0.5))
}
5 {
	C 200,200,200
	F 200,200,200
	W 1
	wt 200,200,200
	wa ((0.5, 0), (1, 0.5), (0.5, 0.5))
}
6 {
	C 200,200,200
	F 200,200,200
	W 1
	wt 200,200,200
	wa ((0.5, 0), (0.5, 0), (0.5, 0.1)), 0.8
	wa ((0, 0.5), (0, 0.5), (0.1, 0.5)), 0.8
	wa ((0.5, 1), (0.5, 1), (0.5, 0.9)), 0.8
	wa ((1, 0.5), (1, 0.5), (0.9, 0.5)), 0.8
}

0 {
	NO 120,120,120
	SO 120,120,120
	WE 120,120,120
	EA 120,120,120
	C 200,200,200
	F 200,200,200
	W 0
}
L ((5.5, 5.5), {0, 255, 255}, 1)
L ((2.5, 2.5), {255, 0, 0}, 1)
P=0

1111111
1400051
1000001
1006001
1000N01
1300021
1111111
