. {
	C 0,0,0
	F 0,0,0
	W 1
	wl ((1, 0), (0, 0)), 0.8
	wl ((0.42, 0.13), (0.77, 0.22)), 0.8
	wl ((0.05, 0.91), (0.33, 0.48)), 0.8
	wl ((0.89, 0.04), (0.58, 0.76)), 0.8
	wl ((0.61, 0.52), (0.19, 0.98)), 0.8
	wl ((0.07, 0.25), (0.86, 0.37)), 0.8
	wl ((0.18, 0.68), (0.73, 0.94)), 0.8
	wl ((0.36, 0.83), (0.59, 0.14)), 0.8
	wl ((0.91, 0.11), (0.02, 0.65)), 0.8
	wl ((0.48, 0.29), (0.44, 0.72)), 0.8
	wl ((0.23, 0.97), (0.36, 0.58)), 0.8
	wl ((0.65, 0.39), (0.27, 0.80)), 0.8
}
# {
	C 0,0,0
	F 0,0,0
	W 1
	wl ((0, 0), (1, 1)), 0.8
	wl ((1, 0), (0, 1)), 0.8
}
1 {
	NO textures/simonkraft/bookshelf_01.xpm
	SO textures/simonkraft/bookshelf_01.xpm
	EA textures/simonkraft/bookshelf_01.xpm
	WE textures/simonkraft/bookshelf_01.xpm
	C textures/wolfenstein/wood.xpm
	F textures/wolfenstein/grey_stone.xpm
	W 1
	wa ((0.5, 0), (0.5, 0), (0.5, 0.5)), 0.8
}
0 {
	NO textures/simonkraft/bookshelf_01.xpm
	SO textures/simonkraft/bookshelf_02.xpm
	WE textures/simonkraft/bookshelf_03.xpm
	EA textures/simonkraft/bookshelf.xpm
	C textures/wolfenstein/wood.xpm
	F textures/wolfenstein/grey_stone.xpm
	W 0
}
P=0

L ((2.5, 2.5), 1)
L ((4.5, 2.5), 1)

111111111
100000001
100000001
100000001
1N0010001
100000001
100000001
100000001 
111111111