   WE                            textures/wolfenstein/grey_stone.xpm    
NO      textures/wolfenstein/purple_stone.xpm



SO textures/wolfenstein/red_brick.xpm

F      17,38,64

	
EA textures/wolfenstein/wood.xpm



C 218, 234, 235

Z {
   NO 1,1,1
   SO 1,1,1
   WE 1,1,1
   EA 1,1,1
   C 1,1,1
   F 1,1,1
   W 1
}

Z {
}

1111111111111111111111111
10S0110000100000000000001
1000110000000000111111001
10Z0110000000000110001001
1111111111111111111111111
 
1111111111111111111111111
1000000000100000000001001
1111111111111111111111111

















